1111111111111111111111111111
1E0C100C100C100C100C100C1001
1P100C100C100C100C100C100C11
1000000000111111111111111111
100C100C100C100C100C100C1001
1C100C100C100C100C100C100C11
1000111111111111111111111101
100C100C100C100C100C100C1001
1C100C100C100C100C100C100C11
1111000101111111111111111111
100C100C100C100C100C100C1001
1C100C100C100C100C100C100C11
1000000000000000000000000001
100C100C100C100C100C100C1001
1C100C100C100C100C100C100C11
1111111111111111111111111111