1111111111111111111111111111
1000000000000000000000000001
10000000C0000000000000000001
1000000000000000000000000001
100000011111000000C000000001
1000000100000000000000000001
100000010P00000000C000000001
1000000000000000000000000001
1000000000000C00000000000001
1000E000000C00000C0000000001
1000000000000000000000000001
1111111111111111111111111111